.................................#
.................................#
.................................#
.................................#
.................................#
############.....................#
...........#.....................#
...........#.........#############
...........#.........#............
...........#.........#............
...........#.........#............
...........#.....^...#............
...........#.....#...#............
...........#.....#...#............
...........#.....#...#............
...........###########............
.................#................
########.........#................
.......#.........#................
.....#############................
.....#.#..........................
.....#.#..........................
.....#.#..........................
.....#.#..........................
.....#.#..........................
.....#.#..........................
.....#.#..........................
.....#########....................
.......#.....#....................
.......#########..................
.............#.#..................
.............#.#..................
.............#.#..................
.............#.#..................
.............#.#..................
.........###########..............
.........#...#.#...#..............
.....###########...#..............
.....#...#...#.....#..............
.....#...#...#########............
.....#...#.........#.#............
.....#...#.........#.#............
.....#...#.........#.#............
.....#...#.........#.#............
.....#...#.........#.#............
##########.........#########......
.....#...............#.....#......
.....###########.....#.....#......
...............#.....#.....#......
...........###########.....#......
...........#...#...........#......
...........#...#...........#......
...........#...#...........#......
...........#...#...........#......
...........#...#...........#......
...........#...#...........#......
...........#...#...........#......